"a" = (/turf/space,/area)
"b" = (/turf/unsimulated/floor/asteroid,/area/mine/unexplored)
"c" = (/turf/unsimulated/mineral/random,/area/mine/unexplored)
"d" = (/turf/unsimulated/mineral/random/high_chance_clown,/area/mine/unexplored)
"e" = (/turf/simulated/floor/mineral/phazon,/obj/item/stack/ore/phazon,/turf/unsimulated/floor/asteroid,/area/mine/unexplored)
"f" = (/turf/simulated/floor/mineral/phazon,/obj/item/stack/ore/phazon,/mob/living/simple_animal/hostile/asteroid/basilisk,/turf/unsimulated/floor/asteroid,/area/mine/unexplored)
"g" = (/turf/simulated/floor/mineral/phazon,/obj/item/stack/ore/phazon,/mob/living/simple_animal/hostile/asteroid/goliath,/turf/unsimulated/floor/asteroid,/area/mine/unexplored)
"h" = (/turf/simulated/floor/mineral/phazon,/obj/item/weapon/pickaxe/drill/diamond,/obj/item/stack/ore/phazon,/turf/unsimulated/floor/asteroid,/area/mine/unexplored)
"i" = (/turf/simulated/floor/mineral/phazon,/obj/item/stack/ore/phazon,/mob/living/simple_animal/hostile/asteroid/hivelord,/turf/unsimulated/floor/asteroid,/area/mine/unexplored)
"j" = (/turf/simulated/floor/mineral/phazon,/obj/item/stack/sheet/mineral/diamond,/turf/unsimulated/floor/asteroid,/area/mine/unexplored)
"k" = (/obj/item/stack/ore/phazon,/turf/unsimulated/floor/asteroid,/area/mine/unexplored)

(1,1,1) = {"
aaaaaaabbbaaaaaaaaaaaaa
aaaabbbbbbbaaaaaaaaaaaa
accccccbbbbaaaaacccccca
acddddccbccccaaacddddcc
ccdddddcccddcaabcdddddc
cdddddddddddcaabcdddddc
cddddeedddddcaabcdddddc
ccdddefegdddcaaccddddcc
acddddehedddccacdddddca
accdddeijedddcacdddddca
aaccdddfegdddcacdddddca
aaaccddddddddcaccddddca
aaaacddddddddcaaccddcca
aaaaccdddddddcaaaccccaa
aaaaacccccccccaaaaaaaaa
aaaaaaaaaaaaaaaaakkaaaa
aaaaaccccaaaaacccckkaaa
aaacccddccaaaccddcckkaa
aaccdddddccaccddddcckka
aacdddddddcacddddddckka
aacdddddddcaccdddddckaa
aacddddddccaaccddcccaaa
aaccdddddcaaaaccccaaaaa
aaacccccccaaaaaaaaaaaaa
"}
